"","Area code","Township","NmMale","NmFemale","NmTotal","AttNmMale","AttNmFemale","AttNmTotal","pcAttNmMale","pcAttNmFemale","pcAttNmTotal"
"1","AREA # 010101","Myitkyina",15267,14965,30232,12438,12455,24893,81.4698369031244,83.227530905446,82.3399047367028
"2","AREA # 010102","Waingmaw",6233,6073,12306,5463,5361,10824,87.6463982031125,88.275975629837,87.9570941004388
"3","AREA # 010103","Ingyanyan",107,101,208,69,73,142,64.4859813084112,72.2772277227723,68.2692307692308
"4","AREA # 010104","Tanaing",2707,2514,5221,2031,1963,3994,75.0277059475434,78.0827366746221,76.4987550277725
"5","AREA # 010105","Chiphwe",798,802,1600,529,513,1042,66.2907268170426,63.9650872817955,65.125
"6","AREA # 010106","Hsotlaw",480,468,948,338,315,653,70.4166666666667,67.3076923076923,68.8818565400844
"7","AREA # 010151","Hsinbo(ST)",620,603,1223,498,497,995,80.3225806451613,82.4212271973466,81.3573180703189
"8","AREA # 010152","Hsadone(ST)",724,738,1462,600,613,1213,82.8729281767956,83.0623306233062,82.96853625171
"9","AREA # 010153","Kanpaikti(ST)",460,486,946,361,389,750,78.4782608695652,80.0411522633745,79.2811839323467
"10","AREA # 010154","Shinbwayyan(ST)",641,625,1266,543,542,1085,84.7113884555382,86.72,85.7030015797788
"11","AREA # 010155","Panwa(ST)",597,655,1252,302,299,601,50.5862646566164,45.6488549618321,48.0031948881789
"12","AREA # 010201","Mohnyin",8889,8645,17534,8025,7898,15923,90.2801214984813,91.3591671486408,90.8121364206684
"13","AREA # 010202","Mogaung",7639,7393,15032,6857,6872,13729,89.7630579918838,92.9527931827404,91.3318254390633
"14","AREA # 010203","Phakant",10049,9440,19489,6548,6286,12834,65.1607125087073,66.5889830508475,65.8525321976499
"15","AREA # 010251","Hopin(ST)",2736,2583,5319,2391,2338,4729,87.390350877193,90.5149051490515,88.9076894153036
"16","AREA # 010252","Kamine(ST)",1216,1244,2460,953,990,1943,78.3717105263158,79.5819935691318,78.9837398373984
"17","AREA # 010301","Bhamo",7008,6936,13944,5666,5695,11361,80.8504566210046,82.1078431372549,81.4759036144578
"18","AREA # 010302","Shwegu",5028,4825,9853,4272,4174,8446,84.964200477327,86.5077720207254,85.7200852532224
"19","AREA # 010303","Momauk",2465,2431,4896,2261,2278,4539,91.7241379310345,93.7062937062937,92.7083333333333
"20","AREA # 010304","Mansi",3097,3042,6139,2556,2505,5061,82.5314820794317,82.3471400394477,82.4401368301026
"21","AREA # 010351","Myohla(ST)",242,214,456,218,198,416,90.0826446280992,92.5233644859813,91.2280701754386
"22","AREA # 010352","Lwe`ge`(ST)",539,511,1050,310,302,612,57.5139146567718,59.0998043052838,58.2857142857143
"23","AREA # 010353","Dotphoneyan(ST)",643,564,1207,532,476,1008,82.7371695178849,84.3971631205674,83.5128417564209
"24","AREA # 010401","Putao",3889,3859,7748,3572,3570,7142,91.8488043198766,92.511013215859,92.1786267423851
"25","AREA # 010402","Sumprabum",169,171,340,158,156,314,93.491124260355,91.2280701754386,92.3529411764706
"26","AREA # 010403","Machanbaw",588,562,1150,544,526,1070,92.5170068027211,93.5943060498221,93.0434782608696
"27","AREA # 010404","Khaunglanphoo",772,778,1550,727,720,1447,94.1709844559585,92.5449871465296,93.3548387096774
"28","AREA # 010405","Naungmoon",359,354,713,346,342,688,96.3788300835655,96.6101694915254,96.4936886395512
"29","AREA # 010451","Pannandin(ST)",118,117,235,96,89,185,81.3559322033898,76.0683760683761,78.7234042553192
"30","AREA # 020101","Loikaw",6685,6620,13305,5829,5910,11739,87.1952131637996,89.2749244712991,88.2299887260428
"31","AREA # 020102","Dimawso",5141,5101,10242,4710,4701,9411,91.6164170394865,92.158400313664,91.8863503222027
"32","AREA # 020103","Phruso",1857,1875,3732,1547,1535,3082,83.306408185245,81.8666666666667,82.583065380493
"33","AREA # 020104","Shardaw",430,449,879,361,382,743,83.953488372093,85.0779510022272,84.5278725824801
"34","AREA # 020201","Bawlakhe",423,413,836,346,365,711,81.7966903073286,88.3777239709443,85.0478468899522
"35","AREA # 020202","Parsaung",1342,1324,2666,1067,1127,2194,79.5081967213115,85.1208459214502,82.2955738934734
"36","AREA # 020203","Meisi",373,363,736,316,334,650,84.7184986595174,92.0110192837466,88.3152173913043
"37","AREA # 020251","Ywathit(ST)",117,101,218,89,91,180,76.0683760683761,90.0990099009901,82.5688073394495
"38","AREA # 030101","Hpa-an",24510,23598,48108,19976,20011,39987,81.5014279885761,84.7995592846851,83.1192317286106
"39","AREA # 030102","Hlaingbwe",10120,9636,19756,7716,7883,15599,76.2450592885375,81.807804068078,78.9582911520551
"40","AREA # 030103","Thandaunggyi",1759,1760,3519,1557,1596,3153,88.5162023877203,90.6818181818182,89.5993179880648
"41","AREA # 030151","Paingkyon(ST)",5943,5662,11605,3488,3663,7151,58.690896853441,64.6944542564465,61.6199913830246
"42","AREA # 030152","Shan Ywathit(ST)",1652,1560,3212,491,581,1072,29.7215496368039,37.2435897435897,33.3748443337484
"43","AREA # 030153","Leiktho(ST)",3122,2993,6115,2721,2677,5398,87.155669442665,89.4420314066154,88.2747342600164
"44","AREA # 030154","Bawgali(ST)",1086,1036,2122,764,766,1530,70.3499079189687,73.9382239382239,72.1017907634307
"45","AREA # 030201","Pharpon",820,844,1664,621,681,1302,75.7317073170732,80.6872037914692,78.2451923076923
"46","AREA # 030251","Kamamaung(ST}",1330,1284,2614,989,1006,1995,74.3609022556391,78.3489096573209,76.3198163733741
"47","AREA # 030301","Myawady",10592,9939,20531,7923,7825,15748,74.8017371601209,78.7302545527719,76.703521504067
"48","AREA # 030351","Sugali(ST)",407,357,764,240,218,458,58.968058968059,61.0644257703081,59.9476439790576
"49","AREA # 030352","Wawlaymyaing(ST)",646,577,1223,443,430,873,68.5758513931889,74.5233968804159,71.3818479149632
"50","AREA # 030401","Kawkareik",13129,12878,26007,10294,10585,20879,78.40658085155,82.194440130455,80.2822317068482
"51","AREA # 030402","Kyarinseikkyi",6254,6186,12440,4440,4629,9069,70.9945634793732,74.8302618816683,72.9019292604502
"52","AREA # 030451","Payarthonezu(ST)",5639,5539,11178,3763,4001,7764,66.7316900159603,72.2332551001986,69.4578636607622
"53","AREA # 030452","Kyaidon(ST)",3979,3968,7947,2054,2255,4309,51.6210103040965,56.8296370967742,54.2217188876306
"54","AREA # 040101","HaKa",2759,2806,5565,2511,2608,5119,91.0112359550562,92.943692088382,91.9856244384546
"55","AREA # 040102","Thantlang",3346,3197,6543,2901,2838,5739,86.7005379557681,88.7707225523929,87.7120586886749
"56","AREA # 040201","Falam",2580,2545,5125,2402,2386,4788,93.1007751937985,93.7524557956778,93.4243902439024
"57","AREA # 040202","Tedim",6029,5973,12002,5379,5370,10749,89.218775916404,89.904570567554,89.5600733211132
"58","AREA # 040203","Tonzaung",1552,1513,3065,1292,1301,2593,83.2474226804124,85.9881031064111,84.6003262642741
"59","AREA # 040251","Rihkhuadal(ST)",394,419,813,376,403,779,95.4314720812183,96.18138424821,95.8179581795818
"60","AREA # 040252","Cikha(ST)",787,747,1534,677,628,1305,86.0228716645489,84.0696117804551,85.0717079530639
"61","AREA # 040301","Mindat",3048,3021,6069,2622,2625,5247,86.0236220472441,86.8917576961271,86.4557587740979
"62","AREA # 040302","Matupi",2497,2511,5008,2206,2196,4402,88.3460152182619,87.4551971326165,87.8993610223642
"63","AREA # 040303","Kanpalet",1539,1533,3072,1340,1357,2697,87.0695256660169,88.5192433137639,87.79296875
"64","AREA # 040304","Paletwat",4355,4136,8491,3563,3238,6801,81.8140068886338,78.2882011605416,80.0965728418325
"65","AREA # 040351","Reazu(ST)",815,828,1643,676,710,1386,82.9447852760736,85.7487922705314,84.357881923311
"66","AREA # 040352","Sami(ST)",2362,2153,4515,1870,1691,3561,79.1701947502117,78.5415699024617,78.8704318936877
"67","AREA # 050101","Sagaing",12657,12185,24842,9096,9426,18522,71.8653709409813,77.3574066475174,74.5592142339586
"68","AREA # 050102","Myinmu",4188,4124,8312,3346,3444,6790,79.8949379178606,83.5111542192047,81.6891241578441
"69","AREA # 050103","Myaung",4367,4219,8586,3400,3553,6953,77.856652163957,84.2142687840721,80.980666200792
"70","AREA # 050201","Shwebo",9458,9261,18719,7334,7502,14836,77.5428208923663,81.0063708022892,79.2563705326139
"71","AREA # 050202","Khin U",6477,6286,12763,5440,5445,10885,83.989501312336,86.6210626789691,85.2855911619525
"72","AREA # 050203","Wetlet",8218,8052,16270,6934,7054,13988,84.3757605256753,87.605563835072,85.9741856177013
"73","AREA # 050204","Kambalu",15005,14734,29739,12603,12604,25207,83.9920026657781,85.5436405592507,84.7607518746427
"74","AREA # 050205","Kyunhlau",5056,5049,10105,4499,4578,9077,88.9833860759494,90.6714200831848,89.8268184067293
"75","AREA # 050206","Ye U",5699,5503,11202,4823,4848,9671,84.6288822600456,88.0974014174087,86.3327977146938
"76","AREA # 050207","Depayin",7004,6978,13982,5952,6141,12093,84.9800114220445,88.0051590713672,86.4897725647261
"77","AREA # 050208","Tasei",8295,8180,16475,7321,7514,14835,88.2579867389994,91.8581907090465,90.0455235204856
"78","AREA # 050251","Kyaukmyaung(ST)",1373,1365,2738,1119,1154,2273,81.5003641660597,84.5421245421245,83.0168005843682
"79","AREA # 050301","Monywa",14245,14010,28255,10526,10945,21471,73.8925938925939,78.1227694503926,75.9900902495134
"80","AREA # 050302","Butalin",5916,5865,11781,5194,5341,10535,87.7958079783638,91.0656436487639,89.4236482471777
"81","AREA # 050303","Ayartaw",6935,6767,13702,5993,6089,12082,86.4167267483778,89.9807891236885,88.1769084805138
"82","AREA # 050304","Chaung Oo",4351,4198,8549,3350,3558,6908,76.9937945299931,84.7546450690805,80.8047724880103
"83","AREA # 050401","Katha",9544,9130,18674,8318,8181,16499,87.1542330259849,89.60569550931,88.3527899753668
"84","AREA # 050402","Indaw",6950,6711,13661,6154,6023,12177,88.5467625899281,89.748174638653,89.1369592269966
"85","AREA # 050403","Tigyaing",6655,6577,13232,5512,5618,11130,82.8249436513899,85.4188839896609,84.1142684401451
"86","AREA # 050404","Banmauk",6334,6101,12435,5705,5578,11283,90.0694663719608,91.4276348139649,90.7358262967431
"87","AREA # 050405","Kawlin",6519,6357,12876,5686,5658,11344,87.2219665592882,89.0042472864559,88.1018949984467
"88","AREA # 050406","Wuntho",3705,3632,7337,3270,3217,6487,88.2591093117409,88.5737885462555,88.4148834673572
"89","AREA # 050407","Pinlebu",6067,6053,12120,5285,5271,10556,87.1105983187737,87.0807863869156,87.0957095709571
"90","AREA # 050501","Kalay",17986,17787,35773,15626,15586,31212,86.8786834204381,87.6257941193006,87.2501607357504
"91","AREA # 050502","Kalewa",2888,2818,5706,2644,2603,5247,91.5512465373961,92.3704755145493,91.9558359621451
"92","AREA # 050503","Mingin",5405,5256,10661,4858,4740,9598,89.8797409805735,90.1826484018265,90.0290779476597
"93","AREA # 050601","Tamu",3278,3242,6520,2937,2918,5855,89.5973154362416,90.0061690314621,89.8006134969325
"94","AREA # 050651","Myothit(ST)",1157,1100,2257,1080,1045,2125,93.3448573898012,95,94.1515285777581
"95","AREA # 050652","Khampat(ST)",2485,2458,4943,2154,2150,4304,86.6800804828974,87.4694873881204,87.0726279587295
"96","AREA # 050701","Mawlaik",2794,2761,5555,2502,2478,4980,89.5490336435218,89.7500905469033,89.6489648964896
"97","AREA # 050702","Phaungpyin",7023,6814,13837,6238,6149,12387,88.8224405524705,90.2406809509833,89.5208498952085
"98","AREA # 050801","Hkamti",2342,2193,4535,1889,1863,3752,80.6575576430401,84.9521203830369,82.7342888643881
"99","AREA # 050802","Homalin",14863,14636,29499,12002,12117,24119,80.750857834892,82.7890133916371,81.7620936302926
"100","AREA # 050803","Leshi",568,639,1207,473,525,998,83.2746478873239,82.1596244131455,82.6843413421707
"101","AREA # 050804","Lahe",3382,3389,6771,1394,1185,2579,41.2182140745121,34.9660666863382,38.0889085807119
"102","AREA # 050805","Nanyun",625,588,1213,443,430,873,70.88,73.1292517006803,71.9703215169002
"103","AREA # 050851","Mobaingluk(ST)",84,83,167,78,74,152,92.8571428571429,89.1566265060241,91.0179640718563
"104","AREA # 050852","Sonemara(ST)",369,412,781,325,369,694,88.0758807588076,89.5631067961165,88.8604353393086
"105","AREA # 050853","Htanparkway(ST)",392,360,752,269,264,533,68.6224489795918,73.3333333333333,70.8776595744681
"106","AREA # 050854","Pansaung(ST)",1123,1082,2205,791,731,1522,70.4363312555654,67.5600739371534,69.0249433106576
"107","AREA # 050855","Donhee(ST)",2122,2084,4206,1164,922,2086,54.8539114043355,44.2418426103647,49.5958155016643
"108","AREA # 050901","Yinmarpin",6496,6463,12959,5818,5861,11679,89.5628078817734,90.6854401980504,90.1226946523652
"109","AREA # 050902","Salingyi",5322,5189,10511,4169,4361,8530,78.3352123261932,84.0431682405088,81.1530777280944
"110","AREA # 050903","Palae",6864,6943,13807,5856,6135,11991,85.3146853146853,88.36237937491,86.8472513942203
"111","AREA # 050904","Kani",6918,6872,13790,6168,6210,12378,89.1587163920208,90.3667054714785,89.7606961566352
"112","AREA # 060101","Dawei",5736,5603,11339,4512,4521,9033,78.6610878661088,80.6889166517937,79.6631096216598
"113","AREA # 060102","Lounglon",7135,6934,14069,6076,6078,12154,85.1576734407849,87.6550331698875,86.3885137536428
"114","AREA # 060103","Thayetchaung",6580,6106,12686,5687,5318,11005,86.4285714285714,87.094660989191,86.7491723159388
"115","AREA # 060104","Yebyu",5939,5638,11577,5012,4864,9876,84.3913116686311,86.2717275629656,85.3070743715989
"116","AREA # 060151","Myitta(ST)",1331,1351,2682,989,1062,2051,74.305033809166,78.6084381939304,76.4727815063385
"117","AREA # 060152","Kaleinaung(ST)",1250,1157,2407,953,935,1888,76.24,80.8124459809853,78.4378894889905
"118","AREA # 060201","Myeik",15695,15161,30856,13256,13117,26373,84.4600191143676,86.5180397071433,85.4712211563391
"119","AREA # 060202","Kyunsu",11107,11125,22232,8953,9133,18086,80.6068245250743,82.0943820224719,81.3512054695934
"120","AREA # 060203","Palaw",5972,5738,11710,5185,5085,10270,86.8218352310784,88.6197281282677,87.7028181041845
"121","AREA # 060204","Tanintharyi",6797,6393,13190,5647,5432,11079,83.0807709283507,84.9679336774597,83.9954510993177
"122","AREA # 060251","Palauk(ST)",2673,2595,5268,2319,2298,4617,86.7564534231201,88.5549132947977,87.6423690205011
"123","AREA # 060301","Kawthoung",6633,6553,13186,5261,5348,10609,79.315543494648,81.6114756600031,80.4565448202639
"124","AREA # 060302","Bokepyin",2888,2909,5797,2058,2153,4211,71.2603878116343,74.0116878652458,72.6410212178713
"125","AREA # 060351","Khamaukgyi",1196,1148,2344,732,709,1441,61.2040133779264,61.7595818815331,61.4761092150171
"126","AREA # 060352","Pyigyimandaing",1070,988,2058,828,798,1626,77.3831775700935,80.7692307692308,79.0087463556851
"127","AREA # 060353","Karathuri(ST)",1138,1106,2244,953,947,1900,83.7434094903339,85.623869801085,84.6702317290553
"128","AREA # 070101","Bago",23664,23185,46849,19930,19836,39766,84.2207572684246,85.5553159370283,84.8812141134282
"129","AREA # 070102","Tanatpin",9053,9043,18096,7737,7965,15702,85.4633823042086,88.0791772641822,86.7705570291777
"130","AREA # 070103","Kawa",12026,11536,23562,10762,10495,21257,89.4894395476468,90.9760748959778,90.2172990408285
"131","AREA # 070104","Waw",10767,10310,21077,9327,9243,18570,86.6258010587908,89.650824442289,88.1055178630735
"132","AREA # 070105","Nyaunglebin",10153,9764,19917,8872,8589,17461,87.3830394957156,87.965997541991,87.6688256263493
"133","AREA # 070106","Kyauktaga",14517,13972,28489,12361,11969,24330,85.1484466487566,85.6641855138849,85.4013829899259
"134","AREA # 070107","Daik U",10541,10490,21031,9078,9260,18338,86.1208613983493,88.2745471877979,87.1950929580144
"135","AREA # 070108","Shwegyin",6362,6123,12485,5383,5298,10681,84.6117573090223,86.5262126408623,85.5506607929515
"136","AREA # 070201","Toungoo",12106,11826,23932,9818,9699,19517,81.1002808524699,82.0142059868087,81.5518970416179
"137","AREA # 070202","Yaedashe",10991,10757,21748,9208,9291,18499,83.7776362478391,86.3716649623501,85.0606952363436
"138","AREA # 070203","Kyaukkyi",7242,7127,14369,5952,6003,11955,82.1872410936205,84.2289883541462,83.1999443245876
"139","AREA # 070204","Pyu",13856,13670,27526,11696,11695,23391,84.4110854503464,85.5523043160205,84.9778391339098
"140","AREA # 070205","Oatwin",8233,8337,16570,6915,7178,14093,83.9912547066683,86.0981168285954,85.0512975256488
"141","AREA # 070206","Htantapin",6511,6267,12778,5628,5521,11149,86.4383351251728,88.0963778522419,87.2515260604163
"142","AREA # 070301","Pyay",8601,8586,17187,6945,7046,13991,80.7464248343216,82.0638248311204,81.404549950544
"143","AREA # 070302","Paukkhaung",4898,4903,9801,3991,4060,8051,81.4822376480196,82.8064450336529,82.1446791143761
"144","AREA # 070303","Padaung",5703,5580,11283,4773,4708,9481,83.6927932667017,84.3727598566308,84.0290702827262
"145","AREA # 070304","Paunde",4866,4741,9607,3789,3625,7414,77.8668310727497,76.4606623075301,77.1728947642344
"146","AREA # 070305","Thegon",4469,4309,8778,3770,3679,7449,84.3589169836653,85.3794383847761,84.8598769651401
"147","AREA # 070306","Shwedaung",4323,4254,8577,3619,3603,7222,83.7150127226463,84.6967559943583,84.201935408651
"148","AREA # 070401","Tharyarwaddy",7218,7436,14654,6171,6479,12650,85.4945968412303,87.1301775147929,86.3245530230654
"149","AREA # 070402","Letpadan",8873,8779,17652,7411,7439,14850,83.5230474473121,84.7363025401526,84.1264445955133
"150","AREA # 070403","Minhla",5497,5362,10859,4681,4607,9288,85.1555393851192,85.9194330473704,85.5327378211622
"151","AREA # 070404","Okpo",5440,5377,10817,4574,4579,9153,84.0808823529412,85.1590106007067,84.6168068780623
"152","AREA # 070405","Zigon",2612,2470,5082,2164,2017,4181,82.8483920367535,81.6599190283401,82.2707595434868
"153","AREA # 070406","Nattalin",6412,6390,12802,5015,5088,10103,78.2127261384903,79.6244131455399,78.9173566630214
"154","AREA # 070407","Monyo",5625,5689,11314,4908,4998,9906,87.2533333333333,87.8537528563895,87.5552412939721
"155","AREA # 070408","Gyobingauk",4366,4263,8629,3548,3455,7003,81.2643151626202,81.0462115880835,81.1565650712713
"156","AREA # 080101","Magway",12816,12533,25349,10156,10446,20602,79.2446941323346,83.3479613819516,81.2734230147146
"157","AREA # 080102","Yenangyoung",6335,6289,12624,5523,5512,11035,87.1823204419889,87.6450946096359,87.4128643852979
"158","AREA # 080103","Chauk",8552,8688,17240,7393,7572,14965,86.4476145930776,87.1546961325967,86.8039443155452
"159","AREA # 080104","Taungdwingyi",11965,11558,23523,9671,9871,19542,80.8274132887589,85.4040491434504,83.0761382476725
"160","AREA # 080105","Myothit",8516,8582,17098,7159,7567,14726,84.0652888680132,88.1729200652529,86.1270324014505
"161","AREA # 080106","Natmauk",10688,10599,21287,9048,9550,18598,84.6556886227545,90.1028398905557,87.3678771080941
"162","AREA # 080201","Minbu",8507,8436,16943,6533,6768,13301,76.7955801104972,80.2275960170697,78.5043970961459
"163","AREA # 080202","Pwint Phyu",7601,7421,15022,6174,6283,12457,81.2261544533614,84.6651394690742,82.9250432698709
"164","AREA # 080203","Ngape",2640,2626,5266,2157,2196,4353,81.7045454545455,83.6252856054836,82.6623623243449
"165","AREA # 080204","Salin",10993,11034,22027,9131,9318,18449,83.0619485126899,84.4480696030451,83.7562990874835
"166","AREA # 080205","Saytottara",2278,2368,4646,2068,2177,4245,90.7813871817384,91.9341216216216,91.3689195006457
"167","AREA # 080301","Thayet",4015,3896,7911,3280,3215,6495,81.6936488169365,82.5205338809035,82.1008722032613
"168","AREA # 080302","Minhla",5788,5801,11589,4371,4432,8803,75.5183137525916,76.4006205826582,75.9599620329623
"169","AREA # 080303","Mindon",2320,2221,4541,1899,1866,3765,81.8534482758621,84.0162089149032,82.9112530279674
"170","AREA # 080304","Kamma",2752,2732,5484,2209,2205,4414,80.2688953488372,80.710102489019,80.4886943836616
"171","AREA # 080305","Aunglan",9960,9896,19856,7825,7912,15737,78.5642570281125,79.9514955537591,79.2556406124094
"172","AREA # 080306","Sinpaungwe`",5340,5252,10592,4572,4598,9170,85.6179775280899,87.5476009139375,86.5747734138973
"173","AREA # 080401","Pakokku",13006,13125,26131,10783,11051,21834,82.9078886667692,84.1980952380952,83.5559297386246
"174","AREA # 080402","Yesagyo",10176,10221,20397,8744,9039,17783,85.9276729559748,88.4355738186087,87.1843898612541
"175","AREA # 080403","Myaing",11344,11377,22721,10158,10355,20513,89.5451339915374,91.0169640502769,90.2821178645306
"176","AREA # 080404","Pauk",9589,9565,19154,8663,8693,17356,90.3431014704349,90.8834291688447,90.6129268038008
"177","AREA # 080405","Seikphyu",5331,5456,10787,4700,4871,9571,88.1635715625586,89.2778592375367,88.727171595439
"178","AREA # 080501","Gangaw",5662,5872,11534,4781,5008,9789,84.4401271635464,85.2861035422343,84.8708167157968
"179","AREA # 080502","Htilin",1960,2036,3996,1718,1757,3475,87.6530612244898,86.2966601178782,86.961961961962
"180","AREA # 080503","Saw",1561,1548,3109,1299,1280,2579,83.2158872517617,82.687338501292,82.9527179157285
"181","AREA # 080551","Kyaukhtu(ST)",1311,1283,2594,1164,1139,2303,88.7871853546911,88.7763055339049,88.7818041634541
"182","AREA # 090101","Aungmyetharzan",9190,8969,18159,6557,6551,13108,71.3492927094668,73.0404727394358,72.1845916625365
"183","AREA # 090102","Chanayeharzan",5606,5259,10865,4007,3911,7918,71.476988940421,74.3677505229131,72.8762080073631
"184","AREA # 090103","Mahaaungmye",8175,7646,15821,6199,5989,12188,75.82874617737,78.3285377975412,77.0368497566525
"185","AREA # 090104","Chanmyatharzi",10952,10705,21657,8283,8295,16578,75.6300219138057,77.4871555347968,76.5479983377199
"186","AREA # 090105","Pyigyidagun",10165,9710,19875,7826,7854,15680,76.9896704377767,80.8856848609681,78.8930817610063
"187","AREA # 090106","Amarapura",9866,9534,19400,7770,7764,15534,78.7553213054936,81.4348646947766,80.0721649484536
"188","AREA # 090107","Patheingyi",12195,11529,23724,9014,8987,18001,73.9155391553916,77.9512533610894,75.8767492834261
"189","AREA # 090201","Pyin Oo Lwin",10403,9815,20218,8084,7972,16056,77.7083533596078,81.2226184411615,79.4143832228707
"190","AREA # 090202","Madaya",12173,12286,24459,9455,10035,19490,77.671896820833,81.6783330620218,79.6843697616419
"191","AREA # 090203","Sinku",7482,7254,14736,6021,6126,12147,80.4731355252606,84.449958643507,82.4307817589577
"192","AREA # 090204","Mogok",8629,8247,16876,7339,7280,14619,85.0504114034071,88.2745240693585,86.6259777198388
"193","AREA # 090205","Thabeikkyin",6933,6690,13623,5584,5640,11224,80.5423337660464,84.304932735426,82.3900756074286
"194","AREA # 090251","Tagaung",2002,1996,3998,1522,1606,3128,76.023976023976,80.4609218436874,78.2391195597799
"195","AREA # 090301","Kyaukse",11691,11347,23038,9581,9655,19236,81.9519288341459,85.088569665991,83.4968313221634
"196","AREA # 090302","Singaing",6295,6140,12435,4963,5064,10027,78.8403494837172,82.4755700325733,80.6353035786088
"197","AREA # 090303","Myitthar",9151,8915,18066,7503,7669,15172,81.9910392306852,86.0235558048233,83.9809587069634
"198","AREA # 090304","Tada U",6222,5879,12101,4825,5006,9831,77.547412407586,85.1505358054091,81.2412197339063
"199","AREA # 090401","Myingyan",11471,11141,22612,8875,8954,17829,77.3690175224479,80.3698052239476,78.8475145940209
"200","AREA # 090402","Taungtha",10916,10646,21562,9316,9510,18826,85.3426163429828,89.3293255682886,87.3110101103794
"201","AREA # 090403","Natogyi",7628,7495,15123,6377,6537,12914,83.5998951232302,87.2181454302869,85.3931098327052
"202","AREA # 090404","Kyaukpadaung",12642,12498,25140,11021,11286,22307,87.1776617623794,90.3024483917427,88.7311058074781
"203","AREA # 090405","Ngazun",5456,5361,10817,4375,4651,9026,80.1869501466276,86.7562022010819,83.442729037626
"204","AREA # 090501","Nyaung U",8619,8075,16694,7364,7008,14372,85.4391460726302,86.7863777089783,86.0908110698455
"205","AREA # 090551","Ngat",2069,1984,4053,1823,1784,3607,88.1101981633639,89.9193548387097,88.9958055761165
"206","AREA # 090601","Yame`thin",11773,11492,23265,9575,9907,19482,81.3301622356239,86.2077967281587,83.7395228884591
"207","AREA # 090602","Pyawbwe",12396,12029,24425,10265,10688,20953,82.8089706356889,88.8519411422396,85.7850562947799
"208","AREA # 090701","Meiktila",13975,13778,27753,11481,12145,23626,82.1538461538462,88.1477718101321,85.1295355457068
"209","AREA # 090702","MahlYaing",6505,6290,12795,5369,5493,10862,82.5365103766334,87.329093799682,84.8925361469324
"210","AREA # 090703","Thazi",10039,9813,19852,8237,8723,16960,82.0500049805757,88.8922857434016,85.4321982671771
"211","AREA # 090704","Wundwin",9587,9467,19054,7751,8148,15899,80.8490664441431,86.0673919932397,83.4417969980057
"212","AREA # 100101","Mawlamyine",12597,11926,24523,10017,9580,19597,79.5189330793046,80.3286936105987,79.9127349834849
"213","AREA # 100102","Kyaikemaraw",11673,11295,22968,9273,9206,18479,79.4397327165253,81.5050907481186,80.4554162312783
"214","AREA # 100103","Chaungzon",6479,6309,12788,5327,5307,10634,82.2194783145547,84.1179267712791,83.1560838285893
"215","AREA # 100104","Thanbyuzayat",9203,8985,18188,7373,7391,14764,80.1151798326633,82.2593210907067,81.1744007037607
"216","AREA # 100105","Mudon",9246,8800,18046,7529,7306,14835,81.4298074843175,83.0227272727273,82.2065831763272
"217","AREA # 100106","Ye",8197,7675,15872,6684,6416,13100,81.5420275710626,83.5960912052117,82.5352822580645
"218","AREA # 100151","Lamine",5306,5241,10547,4336,4451,8787,81.7188088955899,84.9265407365007,83.312790366929
"219","AREA # 100152","Khawzar",1208,1049,2257,934,861,1795,77.317880794702,82.0781696854147,79.5303500221533
"220","AREA # 100201","Thaton",13818,13232,27050,10849,10735,21584,78.5135330728036,81.1290810157195,79.7929759704251
"221","AREA # 100202","Paung",12494,11905,24399,9985,9751,19736,79.9183608131903,81.9067618647627,80.8885610065986
"222","AREA # 100203","Kyaikto",10185,9935,20120,7982,8085,16067,78.3701521845852,81.3789632611978,79.8558648111332
"223","AREA # 100204","Bilin",10763,10347,21110,8617,8628,17245,80.0613211929759,83.3864888373442,81.6911416390336
"224","AREA # 110101","Sittway",6892,6324,13216,5049,4737,9786,73.2588508415554,74.9051233396584,74.0466101694915
"225","AREA # 110102","Ponnagyun",7719,7453,15172,6554,6402,12956,84.9073714211685,85.8982959881927,85.3941471131031
"226","AREA # 110103","Pauktaw",9392,9181,18573,7312,7284,14596,77.8534923339012,79.33776277094,78.5871964679912
"227","AREA # 110104","Yethedaung",7327,6960,14287,6105,5914,12019,83.321959874437,84.9712643678161,84.125428711416
"228","AREA # 110201","Myauk U",11084,10566,21650,9137,8714,17851,82.4341392998917,82.4720802574295,82.4526558891455
"229","AREA # 110202","Kyauktaw",9929,9708,19637,8090,7960,16050,81.4784973310505,81.9942315615987,81.7334623414982
"230","AREA # 110203","Minbya",10370,10364,20734,8405,8454,16859,81.0511089681774,81.5708220764184,81.3108903250699
"231","AREA # 110204","Myebon",8707,8569,17276,7690,7510,15200,88.3197427357299,87.6414984245536,87.9833294744154
"232","AREA # 110301","Maungtaw",2250,2146,4396,1432,1236,2668,63.6444444444444,57.5955265610438,60.6915377616015
"233","AREA # 110302","Buthidaung",3427,3403,6830,2447,2350,4797,71.403559964984,69.0567146635322,70.2342606149341
"234","AREA # 110351","Taungpyoletwe(ST)",157,169,326,114,100,214,72.6114649681529,59.1715976331361,65.6441717791411
"235","AREA # 110401","Kyaukpyu",8847,8698,17545,7489,7393,14882,84.6501638973663,84.9965509312486,84.8218865773725
"236","AREA # 110402","Mannaung",2201,2078,4279,1840,1780,3620,83.5983643798273,85.6592877767084,84.5992054218275
"237","AREA # 110403","Yanbye",5108,4872,9980,4371,4265,8636,85.5716523101018,87.5410509031199,86.5330661322645
"238","AREA # 110404","An",7205,6891,14096,5846,5574,11420,81.1380985426787,80.8881149325207,81.0158910329171
"239","AREA # 110501","Thandwe",5343,5128,10471,4383,4169,8552,82.0325659741718,81.298751950078,81.6731926272562
"240","AREA # 110502","Toungup",5496,5425,10921,4636,4606,9242,84.3522561863173,84.9032258064516,84.6259500045783
"241","AREA # 110503","Gwa",1769,1742,3511,1451,1498,2949,82.023742227247,85.9931113662457,83.9931643406437
"242","AREA # 110551","Maei(ST)",2499,2294,4793,2095,1952,4047,83.8335334133653,85.0915431560593,84.4356353014813
"243","AREA # 110552","Kyeintali(ST)",846,889,1735,664,741,1405,78.4869976359338,83.3520809898763,80.9798270893372
"244","AREA # 120101","Insein",10838,10198,21036,8486,8022,16508,78.2985790736298,78.6624828397725,78.4749952462445
"245","AREA # 120102","Mingaladon",12714,12238,24952,9779,9503,19282,76.9152115777883,77.6515770550744,77.2763706316127
"246","AREA # 120103","Hmawby",10902,10783,21685,8741,8805,17546,80.1779490001834,81.6563108596865,80.9130735531473
"247","AREA # 120104","Hlegu",13240,12681,25921,10378,10128,20506,78.3836858006042,79.8675183345162,79.1096022529995
"248","AREA # 120105","Taikkyi",13438,12833,26271,11028,10546,21574,82.0657835987498,82.1787578898153,82.1209698907541
"249","AREA # 120106","Htantabin",7416,6927,14343,6124,5842,11966,82.5782092772384,84.3366536740292,83.4274559018337
"250","AREA # 120107","Shwepyitha",14201,13743,27944,11083,10975,22058,78.0437997324132,79.8588372262243,78.9364443172058
"251","AREA # 120108","Hlinethaya",26788,26325,53113,20312,20005,40317,75.8249962669852,75.9924026590693,75.9079698002372
"252","AREA # 120201","Thingangyun",6902,6543,13445,5302,5184,10486,76.8183135323095,79.2297111416781,77.9918185198959
"253","AREA # 120202","Yankin",2072,2004,4076,1711,1613,3324,82.5772200772201,80.4890219560878,81.5505397448479
"254","AREA # 120203","South Okkalapa",4740,4513,9253,3722,3596,7318,78.5232067510549,79.6809217815201,79.0878633956555
"255","AREA # 120204","North Okkalapa",11476,10891,22367,8925,8662,17587,77.7710003485535,79.5335598200349,78.6292305628828
"256","AREA # 120205","Thakayta",7383,6899,14282,5581,5425,11006,75.5925775430042,78.6345847224235,77.0620361293936
"257","AREA # 120206","Dawbon",2839,2834,5673,2292,2269,4561,80.7326523423741,80.0635144671842,80.3983782830954
"258","AREA # 120207","Tamway",4754,4553,9307,3537,3398,6935,74.4005048380311,74.6321106962442,74.5138068120769
"259","AREA # 120208","Pazuntaung",1325,1339,2664,925,932,1857,69.811320754717,69.6041822255415,69.7072072072072
"260","AREA # 120209","Botahtaung",1130,1099,2229,821,812,1633,72.6548672566372,73.8853503184713,73.26155226559
"261","AREA # 120210","Dagon Myothit(South)",15203,14749,29952,12014,11731,23745,79.0238768664079,79.5375957692047,79.2768429487179
"262","AREA # 120211","Dagon Myothit(North)",6869,6694,13563,5559,5391,10950,80.9288105983404,80.5348072901105,80.7343508073435
"263","AREA # 120212","Dagon Myothit(East)",6582,6431,13013,5246,5205,10451,79.7022181707688,80.9360908101384,80.3119956966111
"264","AREA # 120213","Dagon Myothit(Seik)",7043,6593,13636,5468,5167,10635,77.6373704387335,78.3709995449719,77.9920797887944
"265","AREA # 120214","Mingala Taungnyunt",4359,4284,8643,3191,3205,6396,73.2048635008029,74.813258636788,74.0020826102048
"266","AREA # 120301","Thanlyin",11460,11143,22603,8899,8521,17420,77.652705061082,76.4695324418918,77.0694155643056
"267","AREA # 120302","Kyauktan",5698,5656,11354,4629,4471,9100,81.2390312390312,79.0487977369166,80.1479654747226
"268","AREA # 120303","Thongwa",7547,7288,14835,6147,6018,12165,81.4495826156088,82.5740944017563,82.0020222446916
"269","AREA # 120304","Khayan",7787,7388,15175,6423,6302,12725,82.4836265570823,85.3004872766649,83.8550247116969
"270","AREA # 120305","Twantay",11433,11343,22776,9613,9742,19355,84.081168547188,85.8855681918364,84.9798033017211
"271","AREA # 120306","Kawhmu",6092,5963,12055,5274,5322,10596,86.5725541694025,89.2503773268489,87.8971381169639
"272","AREA # 120307","Kungyangon",5642,5439,11081,4919,4845,9764,87.1853952499114,89.0788747931605,88.1147910838372
"273","AREA # 120308","Dala",8417,8053,16470,6693,6399,13092,79.5176428656291,79.4610704085434,79.4899817850637
"274","AREA # 120309","Seikkyi/Khanaungto",1710,1653,3363,1492,1476,2968,87.2514619883041,89.2921960072595,88.254534641689
"275","AREA # 120310","Cocogyun",52,40,92,44,30,74,84.6153846153846,75,80.4347826086957
"276","AREA # 120351","Tada(ST)",1528,1514,3042,1189,1168,2357,77.8141361256545,77.1466314398943,77.4819197896121
"277","AREA # 120401","Kyauktada",674,642,1316,473,463,936,70.1780415430267,72.1183800623053,71.1246200607903
"278","AREA # 120402","Pabedan",992,963,1955,687,672,1359,69.2540322580645,69.7819314641744,69.5140664961637
"279","AREA # 120403","Lanmadaw",785,864,1649,517,589,1106,65.859872611465,68.1712962962963,67.0709520921771
"280","AREA # 120404","Latha",447,434,881,278,259,537,62.1923937360179,59.6774193548387,60.9534619750284
"281","AREA # 120405","Ahlon",1489,1452,2941,1100,1053,2153,73.875083948959,72.5206611570248,73.206392383543
"282","AREA # 120406","Kyimyindine",4061,3884,7945,3205,3084,6289,78.9214479192317,79.4026776519053,79.1567023285085
"283","AREA # 120407","Sangyoung",2471,2401,4872,1797,1797,3594,72.7235936867665,74.8438150770512,73.7684729064039
"284","AREA # 120408","Hline",4601,4232,8833,3200,3046,6246,69.550097804825,71.9754253308129,70.7121023434847
"285","AREA # 120409","Kamayut",1960,1896,3856,1477,1454,2931,75.3571428571429,76.6877637130802,76.0114107883817
"286","AREA # 120410","Mayangon",6360,5793,12153,4753,4492,9245,74.7327044025157,77.5418608665631,76.0717518308237
"287","AREA # 120411","Dagon",640,656,1296,557,561,1118,87.03125,85.5182926829268,86.2654320987654
"288","AREA # 120412","Bahan",2346,2344,4690,1534,1608,3142,65.38789428815,68.6006825938567,66.9936034115139
"289","AREA # 120413","Seikkan",80,73,153,58,68,126,72.5,93.1506849315068,82.3529411764706
"290","AREA # 130101","Taunggyi",17501,17012,34513,13954,14298,28252,79.7325867093309,84.0465553726781,81.8590096485382
"291","AREA # 130102","Nyaungshwe",9135,8846,17981,7828,7754,15582,85.6923918992885,87.6554374858693,86.6581391468773
"292","AREA # 130103","Hopon",6401,6438,12839,4701,5190,9891,73.4416497422278,80.6150978564772,77.0387101799206
"293","AREA # 130104","Hsihseng",9352,9581,18933,6917,8002,14919,73.9627887082977,83.5194656090178,78.7989225162415
"294","AREA # 130105","Kalaw",9278,8838,18116,7260,7459,14719,78.2496227635266,84.3969223806291,81.248620004416
"295","AREA # 130106","Pindaya",4413,4344,8757,3667,3948,7615,83.0953999546794,90.8839779005525,86.9590042251913
"296","AREA # 130107","Ywarngan",4694,4557,9251,3757,3942,7699,80.038346825735,86.5042791310072,83.2234353042914
"297","AREA # 130108","Yatsauk",6911,6931,13842,5702,6106,11808,82.5061496165533,88.0969557062473,85.3055916775032
"298","AREA # 130109","Pinlaung",5886,5950,11836,5107,5313,10420,86.765205572545,89.2941176470588,88.036498817168
"299","AREA # 130110","Phekon",6514,6254,12768,5747,5566,11313,88.2253607614369,88.999040614007,88.6043233082707
"300","AREA # 130151","Kyauktalongyi(ST)",2926,2971,5897,2464,2738,5202,84.2105263157895,92.157522719623,88.2143462777684
"301","AREA # 130152","Indaw(ST)",2008,2081,4089,1227,1440,2667,61.105577689243,69.1975012013455,65.2237710931768
"302","AREA # 130153","Naungtayar(ST)",4048,4183,8231,3192,3626,6818,78.8537549407115,86.6841979440593,82.8331915927591
"303","AREA # 130201","Loilem",3005,3007,6012,2168,2344,4512,72.1464226289518,77.9514466245427,75.0499001996008
"304","AREA # 130202","Le`char",2525,2603,5128,1367,1587,2954,54.1386138613861,60.9681137149443,57.6053042121685
"305","AREA # 130203","Nanhsam(South)",5517,5195,10712,3421,3484,6905,62.0083378647816,67.0644850818094,64.4604182225541
"306","AREA # 130204","Kunhing",1006,1014,2020,497,600,1097,49.403578528827,59.1715976331361,54.3069306930693
"307","AREA # 130205","Kehsi",2651,2819,5470,880,1310,2190,33.195020746888,46.4703795672224,40.036563071298
"308","AREA # 130206","Mongkai",4356,4392,8748,1762,2046,3808,40.4499540863177,46.5846994535519,43.5299497027892
"309","AREA # 130207","Mineshu",2483,2507,4990,1076,1334,2410,43.3346757954088,53.2110091743119,48.2965931863727
"310","AREA # 130251","Panglong(ST)",4502,4329,8831,2712,2981,5693,60.2398933807197,68.8611688611689,64.4660853810441
"311","AREA # 130252","Kholan(ST)",1408,1345,2753,581,650,1231,41.2642045454545,48.3271375464684,44.7148565201598
"312","AREA # 130253","Karli(ST)",1755,1666,3421,742,777,1519,42.2792022792023,46.6386554621849,44.4022215726396
"313","AREA # 130254","Minenaung(ST)",1817,1954,3771,709,921,1630,39.0203632361035,47.1340839303992,43.2246088570671
"314","AREA # 130255","Minesan(Monsan)(ST)",1795,1737,3532,926,931,1857,51.5877437325905,53.5981577432355,52.5764439411099
"315","AREA # 130301","Linkhe`",1328,1255,2583,848,880,1728,63.855421686747,70.1195219123506,66.8989547038328
"316","AREA # 130302","Mone`",1659,1600,3259,832,1017,1849,50.1506931886679,63.5625,56.7351948450445
"317","AREA # 130303","Maukme`",2016,2053,4069,832,1124,1956,41.2698412698413,54.7491475888943,48.0707790611944
"318","AREA # 130304","Minepan",1179,1111,2290,597,597,1194,50.6361323155216,53.7353735373537,52.1397379912664
"319","AREA # 130351","Homane(ST)",346,371,717,90,92,182,26.0115606936416,24.7978436657682,25.3835425383543
"320","AREA # 130352","Kengtaung(ST)",442,442,884,276,304,580,62.4434389140271,68.7782805429864,65.6108597285068
"321","AREA # 130401","Lashio",16602,15904,32506,11122,11296,22418,66.9919286832912,71.0261569416499,68.9657294038024
"322","AREA # 130402","Theinni",3177,3134,6311,2110,2212,4322,66.4148567831287,70.5807275047862,68.4836000633814
"323","AREA # 130403","Mineye`",3293,3502,6795,1080,1569,2649,32.7968417856058,44.802969731582,38.9845474613687
"324","AREA # 130404","Tantyan",10733,10658,21391,3724,4170,7894,34.6967297121029,39.1255395008444,36.9033705764106
"325","AREA # 130501","MuSe",4761,4530,9291,3539,3425,6964,74.3331232934258,75.6070640176601,74.9542568076633
"326","AREA # 130502","Namkham",5530,5610,11140,4092,4301,8393,73.996383363472,76.6666666666667,75.3411131059246
"327","AREA # 130503","Kukai",6313,6227,12540,4856,4925,9781,76.9206399493109,79.0910550827044,77.9984051036683
"328","AREA # 130551","Monekoe(ST)",1486,1379,2865,703,644,1347,47.3082099596231,46.7005076142132,47.0157068062827
"329","AREA # 130552","Manhero(ST)",270,251,521,120,108,228,44.4444444444444,43.0278884462151,43.7619961612284
"330","AREA # 130553","Pansai(KyuKute)(ST)",1206,1140,2346,929,917,1846,77.0315091210614,80.4385964912281,78.6871270247229
"331","AREA # 130554","Tamoenye(ST)",4741,4746,9487,2931,2896,5827,61.8224003374815,61.0198061525495,61.4208917466006
"332","AREA # 130601","Kyukme",6388,6329,12717,4420,5002,9422,69.1922354414527,79.0330225944067,74.0898010537076
"333","AREA # 130602","Naungkhio",7389,7214,14603,5361,5769,11130,72.553796183516,79.9695037427225,76.2172156406218
"334","AREA # 130603","Hsipaw",8999,8775,17774,4908,5639,10547,54.5393932659184,64.2621082621083,59.3394846404861
"335","AREA # 130604","Namtu",2807,2813,5620,1883,2205,4088,67.0822942643392,78.386064699609,72.7402135231317
"336","AREA # 130605","Namsan(North)",3903,4044,7947,3165,3347,6512,81.0914681014604,82.7645895153314,81.9428715238455
"337","AREA # 130606","Momeik",3303,3151,6454,2481,2546,5027,75.1135331516803,80.7997461123453,77.8896808180973
"338","AREA # 130607","Mabane",2427,2270,4697,1881,1810,3691,77.5030902348579,79.7356828193833,78.5820736640409
"339","AREA # 130608","Manton",2449,2567,5016,1798,1979,3777,73.4177215189873,77.0938839111804,75.299043062201
"340","AREA # 130651","Minengaw(ST)",1062,1095,2157,632,757,1389,59.5103578154426,69.1324200913242,64.3949930458971
"341","AREA # 130652","Minelon(ST)",1458,1466,2924,905,1110,2015,62.0713305898491,75.7162346521146,68.9124487004104
"342","AREA # 130701","Kunlon",4010,3672,7682,1751,1664,3415,43.6658354114713,45.3159041394335,44.4545691226243
"343","AREA # 130801","Laukine",5079,4843,9922,3198,2954,6152,62.9651506202008,60.9952508775552,62.0036283007458
"344","AREA # 130802","Kongyan",2361,2357,4718,931,868,1799,39.432443879712,36.8264743317777,38.1305637982196
"345","AREA # 130851","Chinshwehaw(ST)",232,216,448,146,139,285,62.9310344827586,64.3518518518518,63.6160714285714
"346","AREA # 130852","Mawhtike(ST)",1557,1505,3062,768,712,1480,49.3256262042389,47.3089700996678,48.3344219464402
"347","AREA # 130901","Hopan",3518,3294,6812,1645,1632,3277,46.7595224559409,49.5446265938069,48.1062830299471
"348","AREA # 130902","Minemaw",5113,4856,9969,2142,1907,4049,41.8932133776648,39.2710049423394,40.6159093188886
"349","AREA # 130903","Panwine",7237,7126,14363,2459,2338,4797,33.9781677490673,32.8094302554028,33.3983151152266
"350","AREA # 130952","Panlon(ST)",374,356,730,178,215,393,47.5935828877005,60.3932584269663,53.8356164383562
"351","AREA # 131001","Makman",1458,1363,2821,380,427,807,26.0631001371742,31.3279530447542,28.6068769939738
"352","AREA # 131002","Pan San(Pan Kham)",6271,5987,12258,1832,1821,3653,29.2138414925849,30.4159011190914,29.8009463207701
"353","AREA # 131003","Naphang",8822,8429,17251,2798,2441,5239,31.7161641351168,28.9595444299442,30.3692539562924
"354","AREA # 131051","ManKan(ST)",89,94,183,37,49,86,41.5730337078652,52.1276595744681,46.9945355191257
"355","AREA # 131101","Kengtung",9547,9070,18617,5384,5582,10966,56.3946789567403,61.5435501653804,58.9031530321749
"356","AREA # 131102","Minekat",2864,2835,5699,342,398,740,11.9413407821229,14.0388007054674,12.9847341638884
"357","AREA # 131103","Mineyan",2895,2753,5648,776,875,1651,26.8048359240069,31.7835088993825,29.2315864022663
"358","AREA # 131104","Minelar",1497,1474,2971,535,586,1121,35.7381429525718,39.7557666214383,37.7314035678223
"359","AREA # 131151","Mine Pauk(ST)",3295,3167,6462,1193,1162,2355,36.206373292868,36.6908746447742,36.4438254410399
"360","AREA # 131201","Minesat",5913,5776,11689,2707,2682,5389,45.7804836800271,46.4335180055402,46.1031739242022
"361","AREA # 131202","Minepyin",3616,3524,7140,1131,1243,2374,31.2776548672566,35.272417707151,33.249299719888
"362","AREA # 131203","Minetung",1292,1258,2550,619,652,1271,47.9102167182663,51.8282988871224,49.843137254902
"363","AREA # 131251","Minekoke(ST)",1385,1300,2685,293,299,592,21.1552346570397,23,22.048417132216
"364","AREA # 131252","Tontar(ST)",974,965,1939,290,313,603,29.7741273100616,32.4352331606218,31.0985043837029
"365","AREA # 131253","Ponparkyin(ST)",2490,2419,4909,1203,1238,2441,48.3132530120482,51.1781727986771,49.7249949073131
"366","AREA # 131254","Monehta(ST)",261,255,516,131,120,251,50.1915708812261,47.0588235294118,48.6434108527132
"367","AREA # 131301","Tachileik",6952,6589,13541,4473,4498,8971,64.3411967779056,68.2652906359083,66.2506461856584
"368","AREA # 131351","Talay(ST)",926,955,1881,623,695,1318,67.2786177105831,72.7748691099476,70.0691121743753
"369","AREA # 131352","Kenglat(ST)",604,622,1226,387,456,843,64.0728476821192,73.3118971061093,68.7601957585644
"370","AREA # 131401","Minephyat",1832,1702,3534,1083,1193,2276,59.1157205240175,70.0940070505288,64.4029428409734
"371","AREA # 131402","Mineyaung",991,1038,2029,599,753,1352,60.4439959636731,72.5433526011561,66.6338097585017
"372","AREA # 131451","Mineyu(ST)",2791,2699,5490,1134,1094,2228,40.6305983518452,40.5335309373842,40.5828779599271
"373","AREA # 140101","Kangyidaunt",9039,8926,17965,7598,7515,15113,84.0579710144928,84.1922473672418,84.1246868911773
"374","AREA # 140102","Kyaungon",7648,7512,15160,6300,6360,12660,82.3744769874477,84.6645367412141,83.509234828496
"375","AREA # 140103","Kyonpyaw",11530,11321,22851,9802,9718,19520,85.0130095403296,85.8404734564084,85.4229574198066
"376","AREA # 140104","Ngaputaw",9825,9601,19426,8116,8027,16143,82.6055979643766,83.6058743880846,83.0999691135591
"377","AREA # 140105","Pathein",11868,11375,23243,9282,9018,18300,78.2103134479272,79.2791208791209,78.7333820935335
"378","AREA # 140106","Yekyi",4691,4628,9319,3884,3884,7768,82.7968450223833,83.923941227312,83.356583324391
"379","AREA # 140107","Thapaung",8106,7911,16017,6868,6784,13652,84.7273624475697,85.7540133990646,85.2344384091902
"380","AREA # 140151","Ngayokaung(ST)",1915,1885,3800,1617,1566,3183,84.4386422976501,83.0769230769231,83.7631578947368
"381","AREA # 140152","Hainggyikyun(ST)",5337,5291,10628,4417,4472,8889,82.7618512272812,84.5208845208845,83.6375611592021
"382","AREA # 140153","Shwethaungyan(ST)",2182,2259,4441,1591,1684,3275,72.9147571035747,74.5462594068172,73.7446521053817
"383","AREA # 140154","Ngwehsaung(ST)",2077,2166,4243,1489,1597,3086,71.6899374097256,73.730378578024,72.7315578600047
"384","AREA # 140155","Ngathaingchaung(ST)",4180,4093,8273,3500,3519,7019,83.7320574162679,85.9760566821402,84.8422579475402
"385","AREA # 140201","Kyaiklatt",10386,9945,20331,8792,8502,17294,84.6524167148084,85.4901960784314,85.0622202547833
"386","AREA # 140202","Daydaye",11265,10959,22224,9775,9628,19403,86.7731913004882,87.8547312711014,87.3065154787617
"387","AREA # 140203","Phyapon",9667,9501,19168,7883,7933,15816,81.545463949519,83.4964740553626,82.5125208681135
"388","AREA # 140204","Bogale",16884,16672,33556,13643,13496,27139,80.804311774461,80.9500959692898,80.8767433543927
"389","AREA # 140251","Ahmar(ST)",7725,7783,15508,6068,6176,12244,78.5501618122977,79.3524347937813,78.9527985555842
"390","AREA # 140301","Nyaungdon",10409,10201,20610,8725,8640,17365,83.8216927658757,84.697578668758,84.2552159146046
"391","AREA # 140302","Danubyu",8438,8258,16696,6906,6867,13773,81.8440388717706,83.1557277791233,82.4928126497365
"392","AREA # 140303","Pantanaw",12911,12915,25826,10415,10499,20914,80.6676477422353,81.2930700735579,80.9804073414389
"393","AREA # 140304","Maubin",16650,16268,32918,14077,13933,28010,84.5465465465466,85.6466683058766,85.0902241934504
"394","AREA # 140401","Myaungmya",15251,15112,30363,12413,12512,24925,81.3913841715297,82.795129698253,82.0900438033132
"395","AREA # 140402","Wakema",15192,14875,30067,12377,12346,24723,81.4705107951553,82.9983193277311,82.2263611268168
"396","AREA # 140403","Einme",10419,10063,20482,8652,8356,17008,83.0405989058451,83.0368677332803,83.0387657455327
"397","AREA # 140501","Mawlamyinegyun",15368,15292,30660,12426,12544,24970,80.8563248308173,82.0298195134711,81.4416177429876
"398","AREA # 140502","Labutta",11722,11360,23082,9665,9485,19150,82.4518000341239,83.4947183098592,82.9650810155099
"399","AREA # 140551","Pyinsalu(ST)",4105,4107,8212,3231,3350,6581,78.7088915956151,81.5680545410275,80.1388212372138
"400","AREA # 140601","Kyangin",3515,3420,6935,2875,2883,5758,81.7923186344239,84.2982456140351,83.0281182408075
"401","AREA # 140602","Zalun",7841,7592,15433,6687,6617,13304,85.2824894783829,87.1575342465753,86.2048856346789
"402","AREA # 140603","Myanaung",9364,9108,18472,7766,7698,15464,82.9346433148227,84.5191040843215,83.7158943265483
"403","AREA # 140604","Laymyethna",4943,4880,9823,4175,4222,8397,84.4628767954683,86.516393442623,85.4830499847297
"404","AREA # 140605","Hinthada",14882,14999,29881,12486,12774,25260,83.9000134390539,85.1656777118475,84.5353234496837
"405","AREA # 140606","Ingapu",9328,9148,18476,7782,7716,15498,83.426243567753,84.3463052033231,83.8817925958
"406","AREA # 150101","Tatkon",10441,10204,20645,9313,9208,18521,89.196437122881,90.2391219129753,89.7117946233955
"407","AREA # 150102","Zeyarthiri",5399,5313,10712,4706,4707,9413,87.1642896832747,88.5940146809712,87.8734129947722
"408","AREA # 150103","Ottarathiri",4107,4012,8119,3496,3520,7016,85.1229607986365,87.7367896311067,86.4145830767336
"409","AREA # 150104","Pobbathiri",5690,5692,11382,4828,4872,9700,84.8506151142355,85.5938158819396,85.2222807942365
"410","AREA # 150201","Pyinmana",9028,8790,17818,7166,7133,14299,79.3752769162605,81.1490329920364,80.2503086766192
"411","AREA # 150202","Lewe",15460,15022,30482,13226,13254,26480,85.5498059508409,88.2305951271469,86.8709402270192
"412","AREA # 150203","Zabuthiri",3574,3551,7125,2809,2771,5580,78.5954113038612,78.0343565192903,78.3157894736842
"413","AREA # 150204","Dekkhinathiri",2236,2097,4333,1151,1096,2247,51.4758497316637,52.2651406771578,51.8578352180937
